##########
#00000000#
#00000000####
#0000###0000#
#0000#000B00#
#0000###0000#
#00000000####
#000###00#
#F0000000#
##########